創世記	創	Gen
創世紀	創	Gen
出埃及記	出	Exo
利未記	利	Lev
民數記	民	Num
申命記	申	Deu
約書亞記	書	Jos
士師記	士	Jug
路得記	得	Rut
撒母耳記上	撒上	1Sa
撒母耳記下	撒下	2Sa
列王紀上	王上	1Ki
列王紀下	王下	2Ki
歷代志上	代上	1Ch
歷代志下	代下	2Ch
以斯拉記	拉	Ezr
尼希米記	尼	Neh
以斯帖記	斯	Est
約伯記	伯	Job
詩篇	詩	Psm
箴言	箴	Pro
傳道書	傳	Ecc
雅歌	歌	Son
以賽亞書	賽	Isa
耶利米書	耶	Jer
耶利米哀歌	哀	Lam
以西結書	結	Eze
但以理書	但	Dan
何西阿書	何	Hos
約珥書	珥	Joe
阿摩司書	摩	Amo
俄巴底亞書	俄	Oba
約拿書	拿	Jon
彌迦書	彌	Mic
那鴻書	鴻	Nah
哈巴谷書	哈	Hab
西番雅書	番	Zep
哈該書	該	Hag
撒迦利亞書	亞	Zec
瑪拉基書	瑪	Mal
馬太福音	太	Mat
馬可福音	可	Mak
路加福音	路	Luk
約翰福音	約	Jhn
使徒行傳	徒	Act
羅馬書	羅	Rom
哥林多前書	林前	1Co
哥林多後書	林後	2Co
加拉太書	加	Gal
以弗所書	弗	Eph
腓利比書	腓	Phl
歌羅西書	西	Col
帖撒羅尼迦前書	帖前	1Ts
帖撒羅尼迦後書	帖後	2Ts
提摩太前書	提前	1Ti
提摩太後書	提後	2Ti
提多書	多	Tit
腓利門書	門	Phm
希伯來書	來	Heb
雅各書	雅	Jas
彼得前書	彼前	1Pe
彼得後書	彼後	2Pe
約翰壹書	約一	1Jn
約翰貳書	約二	2Jn
約翰參書	約三	3Jn
猶大書	猶	Jud
啟示錄	啟	Rev